Testouillage
An Interactive Fiction by Moi
Release 1 / Serial number 180503 / Inform 7 build 6M62 (I6/v6.33 lib 6/12N) SD

Gazebo
A white canvas parasol raised up on stakes driven into the grass.

>look
Gazebo
A white canvas parasol raised up on stakes driven into the grass.

>merde
That's not a verb I recognise.

>take
What do you want to take?

>look canvas
You can't see any such thing.

>take canvas
You can't see any such thing.

>exit
But you aren't in anything at the moment.

>Mais si, je suis dans mon histoire !
You seem to want to talk to someone, but I can't see whom.

>look gazebo
You can't see any such thing.

>look The
What do you want to look?